26
1 5
1 5
205 0 3 0 0 208 208 208 0 0 133
3 0 6 0 3 3 3 3 3 3 0
3 0 3 0 133 133 133 127 3 3 208
3 0 3 3 3 3 3 221 3 3 208
3 0 219 3 3 3 3 3 3 127 0
31 0 6 219 3 3 225 9 140 7 3
3 0 219 3 3 3 3 3 3 127 0
3 0 3 3 3 3 3 221 3 3 208
3 0 3 0 133 133 133 127 3 3 208
3 0 6 0 3 3 3 3 3 3 0
205 0 3 0 0 208 208 208 0 0 133