22
5 1
5 9
3 3 3 3 3 31 3 3 3 3 3
3 3 3 3 3 0 3 3 3 3 3
3 3 3 3 0 0 0 3 3 3 3
9 9 9 3 3 7 3 3 9 9 9
207 207 9 3 3 219 3 3 9 208 208
30 207 133 7 219 0 219 7 133 208 30
207 207 9 3 3 219 3 3 9 208 208
9 9 9 3 3 7 3 3 9 9 9
3 3 3 9 9 133 9 9 3 3 3
3 3 3 9 205 205 205 9 3 3 3
3 3 3 9 205 30 205 9 3 3 3
