3
1 10
10 9
212 101 200 1 510 511 512 1 1 1 1
101 200 0 1 0 0 0 1 0 102 0
200 103 0 1 1 5 1 1 0 1 0
1 5 1 1 0 103 0 1 200 1 101
0 0 0 1 1 1 0 1 200 1 102
100 1 0 102 101 102 0 1 200 1 101
100 1 1 1 1 1 0 0 0 1 0
0 0 0 0 0 1 1 5 1 1 0
1 1 1 1 102 1 101 0 101 1 0
1 0 0 0 0 1 208 102 200 1 0
31 0 1 1 1 1 207 205 200 1 30
