7
5 10
1 0 
30 0 0 0 0 0 0 0 1 1 1
1 1 0 113 1 6 1 109 0 1 1
1 0 113 208 1 116 1 207 109 0 1
0 0 1 1 1 9 1 1 1 0 0
0 0 6 116 9 222 9 116 6 0 0
0 1 1 1 1 9 1 1 1 1 0
0 1 204 207 1 116 1 208 204 1 0
0 1 200 204 1 6 1 204 200 1 0
0 1 1 201 201 205 201 201 1 1 0
0 0 1 1 1 7 1 1 1 0 0
1 0 0 5 31 0 0 5 0 0 1