12
9 10
1 10
550 208 1 0 117 124 117 0 1 205 226
207 0 1 0 1 5 1 0 1 0 205
0 0 1 0 1 124 1 0 1 0 0
0 122 1 0 1 200 1 0 1 131 0
122 123 1 0 1 200 1 0 1 125 131
1 6 1 0 1 204 1 0 1 6 1
0 0 0 0 1 204 1 0 0 0 0
1 1 1 0 1 1 1 0 1 1 1
208 122 5 120 120 121 120 120 5 122 207
1 1 1 1 1 6 1 1 1 1 1
30 0 0 0 0 0 0 0 0 0 31