23
5 1
5 1
205 3 3 3 3 31 3 3 3 3 205
0 0 0 0 0 0 0 0 0 0 0
3 6 3 3 203 6 203 3 3 6 3
0 0 0 3 3 203 3 3 0 0 0
0 3 133 3 3 3 3 3 133 3 0
0 3 133 3 3 3 3 3 133 3 0
204 3 133 3 3 8 3 3 133 3 204
204 3 127 221 3 9 3 221 127 3 204
204 3 3 3 3 140 3 3 3 3 204
0 3 3 3 127 7 127 3 3 3 0
133 0 205 205 0 3 0 205 205 0 133