20
5 4
5 6
137 207 116 204 129 202 129 204 116 207 137
205 3 200 3 201 3 201 3 200 3 205
3 208 116 0 132 0 132 0 116 208 3
204 3 200 3 0 31 0 3 200 3 204
129 201 132 0 0 0 0 0 132 201 129
202 3 0 3 0 3 0 3 0 3 202
129 201 132 0 0 0 0 0 132 201 129
204 3 200 3 0 0 0 3 200 3 204
3 208 116 0 132 0 132 0 116 208 3
205 3 200 3 201 3 201 3 200 3 205
137 207 116 204 129 202 129 204 116 207 137