0
5 10
5 1
1 3 3 3 3 30 3 3 3 3 1
1 3 3 3 3 0 3 3 3 3 1
1 3 3 3 3 0 3 3 3 3 1
1 3 3 3 3 0 3 3 3 3 1
1 3 3 3 3 0 3 3 3 3 1
1 3 3 3 3 0 3 3 3 3  1
1 3 3 3 3 0 3 3 3 3 1
1 1 1 1 1 5 1 1 1 1 1
2 1 2 1 0 400 499 1 2 1 2
2 2 2 2 2 0 2 2 2 2 2
2 2 2 2 2 0 2 2 2 2 2



