19
9 10
5 4
0 0 0 0 0 0 0 0 0 0 0
0 3 0 3 3 3 3 3 0 3 0
0 3 0 3 3 3 3 3 0 3 0
0 3 0 3 3 30 3 3 0 3 0
0 3 0 3 3 0 3 3 0 3 0
0 3 135 3 3 0 3 3 135 3 0
0 3 9 3 3 138 3 3 9 3 0
0 3 210 3 3 408 3 3 214 3 0
0 3 3 3 3 0 3 3 3 3 0
0 3 3 3 3 0 3 3 3 3 0
0 0 0 0 0 0 0 0 0 0 31