17
5 8
1 10
3 132 128 0 0 0 0 0 0 0 132
3 128 3 3 3 3 3 3 3 3 0
3 0 3 132 0 0 0 0 0 0 132
3 0 3 0 3 3 3 3 3 3 3
3 0 3 0 3 132 0 0 0 132 3
3 0 3 132 0 0 3 3 3 0 3
3 0 3 3 3 3 3 132 0 132 3
3 128 3 3 3 31 3 0 3 3 3
3 132 128 0 137 0 3 132 0 0 132
3 3 3 3 3 3 3 3 3 3 0
30 0 137 0 0 0 0 0 0 0 132