18
1 10
9 10
3 3 3 3 3 3 3 3 3 3 3
3 3 3 3 3 3 3 3 3 3 3
3 3 3 3 3 3 3 3 3 3 3
3 3 3 3 1 1 1 3 3 3 3
3 3 3 1 1 402 1 1 3 3 3
3 3 3 1 1 9 1 1 3 3 3
3 3 3 1 1 7 1 1 3 3 3
3 3 3 3 1 7 1 3 3 3 3
3 3 3 3 3 3 3 3 3 3 3
3 3 3 3 3 3 3 3 3 3 3
31 0 0 0 0 0 0 0 0 0 0