9
6 3
2
6 4 8 7 4
6 6 10 4 6
228 200 0 1 1 1 0 0 0 1 0
200 0 119 5 0 0 0 1 0 5 109
1 5 1 1 0 1 1 1 0 1 200
0 0 0 1 0 1 0 0 0 1 200
0 0 0 7 0 1 31 1 0 1 204
1 6 1 1 0 1 1 1 0 1 1
208 118 207 1 111 1 30 1 0 1 204
1 5 1 1 0 0 0 5 0 1 200
109 204 109 1 1 6 1 1 0 1 200
201 109 204 1 110 111 110 1 0 5 109
211 201 109 5 205 110 205 1 0 1 0
