10
4 6
2
5 6 9 6 7
0 10 11 1 10
0 1 1 208 119 1 119 207 1 1 0
0 0 1 1 5 1 5 1 1 0 118
0 0 0 0 0 1 0 0 0 118 205
107 1 0 1 1 1 1 1 0 1 1
113 1 0 0 200 200 200 0 0 1 200
107 1 0 1 1 1 1 5 1 1 200
0 1 0 9 0 31 1 0 5 113 0
0 1 1 1 1 1 1 5 1 1 0
0 1 204 208 207 1 0 113 0 1 200
0 1 204 208 207 7 111 1 111 1 200
30 1 204 208 207 1 201 1 201 1 204
