17
5 8
2
5 7 16 5 6
0 10 18 1 10
3 132 129 0 0 0 0 0 0 0 132
3 129 3 3 3 3 3 3 3 3 0
3 0 3 132 0 0 0 0 0 0 132
3 0 3 0 3 3 3 3 3 3 3
3 0 3 0 3 132 0 0 0 132 3
3 0 3 132 0 0 3 3 3 0 3
3 0 3 3 3 3 3 132 0 132 3
3 129 3 3 3 31 3 0 3 3 3
3 132 129 0 137 0 3 132 0 0 132
3 3 3 3 3 3 3 3 3 3 0
30 0 137 0 0 0 0 0 0 0 132
