0
5 10
5 2
1 1 1 1 1 1 1 1 1 1 1
1 2 0 2 0 30 0 3 0 3 1
1 0 0 0 0 0 0 0 0 0 1
1 0 0 5 6 7 8 9 0 0 1
1 0 0 200 201 202 203 204 0 0 1
1 0 0 205 206 207 208 210 0 0 1
1 0 0 211 212 213 215 216 0 0 1
1 0 0 218 219 220 221 222 0 0 1
1 0 0 224 225 226 0 0 0 0  1
1 0 0 0 0 0 0 0 0 0 1
1 1 1 0 0 0 0 0 1 1 1