6
9 9
4 9
220 0 1 208 1 200 0 219 1 205 205
0 200 1 207 1 0 200 0 1 0 205
200 0 6 0 6 0 0 200 1 0 0
0 0 1 0 1 0 0 0 1 0 0
1 1 1 7 1 1 1 1 1 5 1
0 0 0 0 200 200 200 0 0 0 0
0 1 1 1 1 1 1 1 1 1 1
0 1 0 5 0 0 0 0 0 0 1
0 1 5 1 5 1 1 1 1 6 1
0 1 0 1 0 0 1 1 0 0 1
0 0 0 1 30 0 5 5 0 31 1