13
1 10
2
0 10 12 1 10
5 10 14 5 9
0 122 0 0 0 0 0 1 0 123 0
0 1 1 1 1 1 5 1 0 1 0
0 1 0 0 120 0 0 1 0 1 0
205 1 7 1 1 1 0 1 0 1 0
117 1 0 0 123 1 120 1 207 1 0
124 1 0 128 9 1 121 1 207 1 0
117 1 123 9 560 1 120 1 207 1 208
0 1 1 1 1 1 0 1 0 1 208
0 117 0 1 0 0 0 123 0 1 208
1 1 0 1 205 1 1 1 1 1 0
31 0 0 6 0 30 1 221 128 5 0
