5
0 9
9 9
0 1 0 1 0 0 0 0 0 0 0
0 1 0 1 0 0 0 0 0 0 0
0 5 0 1 0 0 1 1 5 1 1
0 1 0 1 0 0 1 0 0 0 0
0 1 0 1 1 1 1 0 0 0 0
0 1 0 0 0 0 0 0 0 0 0
0 1 1 0 1 1 1 1 0 0 0 
0 0 1 0 1 0 0 0 0 0 0 
1 1 1 0 1 5 1 6 1 5 1 
0 0 1 0 1 0 1 0 5 0 1 
31 0 0 0 0 0 1 0 1 0 30
