4
10 9
2
0 10 5 0 9
10 10 3 10 9
0 104 0 1 0 401 0 1 0 104 0
5 1 5 1 0 0 0 1 5 1 5
0 1 0 1 1 9 1 1 0 1 0
0 1 103 1 107 113 107 1 103 1 0
102 1 204 1 208 107 208 1 204 1 102
102 1 204 1 1 7 1 1 204 1 102
101 1 0 1 108 112 108 1 0 1 101
0 1 0 1 207 108 207 1 0 1 0
0 1 0 1 1 6 1 1 0 1 0
0 1 0 1 200 0 200 1 0 1 0
30 1 0 104 0 0 0 104 0 1 31
