5
0 9
2
0 10 4 0 9
10 10 6 9 9
203 1 204 1 205 106 0 0 106 200 201
0 1 207 1 106 0 0 0 0 106 200
107 1 0 1 105 0 1 1 5 1 1
0 5 106 1 216 105 1 0 108 105 530
107 1 0 1 1 1 1 0 0 0 105
207 1 0 0 0 102 103 0 0 0 0
208 1 1 104 1 1 1 1 0 0 0
0 520 1 104 1 0 0 0 108 112 0
1 1 1 102 1 5 1 6 1 5 1
0 0 1 0 1 102 1 208 5 0 1
31 0 102 0 0 0 1 200 1 0 30
