3
1 10
10 9
0 0 0 1 0 0 0 1 1 1 1
0 0 0 1 0 0 0 1 0 0 0
0 0 0 1 1 5 1 1 0 1 0
1 5 1 1 0 0 0 1 0 1 0
0 0 0 1 1 1 0 1 0 1 0
0 1 0 0 0 0 0 1 0 1 0
0 1 1 1 1 1 0 0 0 1 0
0 0 0 0 0 1 1 5 1 1 0
1 1 1 1 0 1 0 0 0 1 0
1 0 0 0 0 1 0 0 0 1 0
31 0 1 1 1 1 0 0 0 1 30
