0
5 10
5 1
1 3 3 3 3 30 3 3 3 3 1
1 3 3 3 3 0 3 3 3 3 1
1 3 3 3 3 0 3 3 3 3 1
1 3 3 3 3 0 3 3 3 3 1
1 3 3 3 3 0 3 3 3 3 1
1 3 3 3 3 0 3 3 3 3  1
1 3 3 3 3 0 3 3 3 3 1
1 1 1 1 1 5 1 1 1 1 1
2 1 2 1 0 400 499 1 2 1 2
2 2 2 2 2 0 2 2 2 2 2
2 2 2 2 2 0 2 2 2 2 2

1 1 1 1 1 1 1 1 1 1 1
1 0 0 0 0 30 0 0 0 0 1
1 0 407 0 0 0 0 0 0 0 1
1 0 0 0 0 0 0 0 0 0 1
1 0 405 0 0 499 0 0 406 0 1
1 0 0 0 0 0 0 0 0 0 1
1 0 403 0 0 0 0 0 404 0 1
1 0 0 0 0 0 0 0 0 0 1
1 0 400 0 0 0 0 0 401 0 1
1 0 0 0 0 0 0 0 0 0 1
1 1 1 0 0 0 0 0 1 1 1

0 0 0 0 0 0 0 0 0 0 0
0 0 0 0 0 0 0 0 0 0 0
0 0 0 0 0 0 0 0 0 0 0
0 0 0 0 0 0 0 0 0 0 0
0 0 0 0 0 0 0 0 0 0 0
0 0 0 0 0 0 0 0 0 0 0
0 0 0 0 0 0 0 0 0 0 0
0 0 0 0 0 0 0 0 0 0 0
0 0 0 0 0 0 0 0 0 0 0
0 0 0 0 0 0 0 0 0 0 0
0 0 0 0 0 0 0 0 0 0 0



