8
0 1
2
0 0 7 1 0
6 4 9 6 3
31 1 0 0 0 0 1 0 200 109 0
0 1 0 1 1 5 1 5 1 1 0
0 1 0 1 0 0 6 0 0 1 207
0 1 0 1 111 1 1 1 107 1 104
107 1 0 1 204 1 30 0 0 1 104
113 1 208 1 204 1 1 1 1 1 0
107 1 104 1 0 0 0 1 0 113 0
0 1 104 1 1 1 112 1 5 1 1
0 1 0 109 0 1 109 1 0 0 0
0 1 1 1 5 1 0 1 1 1 0
0 0 111 0 0 1 0 115 116 115 0
