24
5 10
0
2 2 2 9 9 9 9 9 2 2 2
2 2 2 9 321 322 323 9 2 2 2
2 2 2 9 324 325 326 9 2 2 2
2 2 2 9 327 142 329 9 2 2 2
2 2 2 9 9 0 9 9 2 2 2
2 205 205 205 205 127 205 205 205 205 2
2 2 2 2 2 133 2 2 2 2 2
2 2 2 220 133 140 133 220 2 2 2
2 2 2 2 2 133 2 2 2 2 2
2 2 2 2 205 127 205 2 2 2 2
2 2 2 2 2 0 2 2 2 2 2