6
9 9
2
4 10 7 5 10
9 10 5 10 9
220 109 1 208 1 200 115 219 1 205 205
109 200 1 207 1 0 200 115 1 110 205
200 113 6 0 6 113 0 200 1 0 110
0 0 1 112 1 0 0 0 1 118 0
1 1 1 7 1 1 1 1 1 5 1
0 0 114 0 200 200 200 0 114 0 0
0 1 1 1 1 1 1 1 1 1 1
0 1 107 5 107 0 0 0 0 0 1
0 1 5 1 5 1 1 1 1 6 1
0 1 107 1 0 0 1 1 0 0 1
0 0 0 1 30 0 5 5 0 31 1
