4
10 9
0 9
0 0 0 1 0 0 0 1 0 0 0
5 1 5 1 0 0 0 1 5 1 5
0 1 0 1 1 9 1 1 0 1 0
0 1 0 1 0 0 0 1 0 1 0
0 1 0 1 0 0 0 1 0 1 0
0 1 0 1 1 7 1 1 0 1 0
0 1 0 1 0 0 0 1 0 1 0
0 1 0 1 0 0 0 1 0 1 0
0 1 0 1 1 6 1 1 0 1 0
0 1 0 1 0 0 0 1 0 1 0
30 1 0 0 0 0 0 0 0 1 31