16
5 0
2
6 0 15 7 0
5 7 17 5 8
3 3 3 3 3 0 31 3 3 3 3
3 3 3 3 3 0 3 3 3 3 3
3 3 3 3 3 0 3 3 3 3 3
3 3 3 3 1 7 1 3 3 3 3
3 3 3 1 407 0 1 1 3 3 3
3 3 3 1 1 134 1 1 3 3 3
3 3 3 1 1 0 1 1 3 3 3
3 3 3 1 1 30 1 1 3 3 3
3 3 3 3 1 1 1 3 3 3 3
3 3 3 3 3 3 3 3 3 3 3
3 3 3 3 3 3 3 3 3 3 3
