8
0 1
7 4
31 1 0 0 0 0 1 0 200 0 0
0 1 0 1 1 5 1 5 1 1 0
0 1 0 1 0 0 6 0 0 1 207
0 1 0 1 0 1 1 1 0 1 0
0 1 0 1 204 1 30 0 0 1 0
0 1 208 1 204 1 1 1 1 1 0
0 1 0 1 0 0 0 1 0 0 0
0 1 0 1 1 1 0 1 5 1 1
0 1 0 0 0 1 0 1 0 0 0
0 1 1 1 5 1 0 1 1 1 0
0 0 0 0 0 1 0 0 0 0 0

