2
0 1
0 9
31 1 0 0 0 1 0 0 0 0 1
0 1 0 1 0 1 0 0 0 0 1
0 1 0 1 0 1 0 0 0 0 1
0 1 0 1 0 1 1 1 1 5 1
0 1 0 1 0 0 0 5 0 0 1
0 1 5 1 1 5 1 1 5 1 1
0 8 0 0 0 0 1 0 0 0 1
0 1 5 1 1 6 1 9 1 9 1
0 1 0 1 0 0 1 0 1 0 1
0 1 0 1 0 0 1 0 1 0 1
30 1 0 1 0 0 1 0 1 0 1
