2
0 1
0 9
31 1 0 124 0 1 207 208 200 202 1
0 1 208 1 205 1 207 208 200 201 1
0 1 200 1 200 1 207 208 200 117 1
0 1 200 1 200 1 1 1 1 5 1
0 1 0 1 0 0 0 5 0 0 1
0 1 5 1 1 5 1 1 5 1 1
0 8 0 0 0 0 1 0 117 0 1
0 1 5 1 1 6 1 9 1 9 1
0 1 200 1 205 204 1 0 1 0 1
0 1 200 1 205 204 1 0 1 0 1
30 1 207 1 205 204 1 0 1 0 1

31 1 0 0 0 1 0 0 0 0 1
0 1 0 1 0 1 0 0 0 0 1
0 1 0 1 0 1 0 0 0 0 1
0 1 0 1 0 1 1 1 1 5 1
0 1 0 1 0 0 0 5 0 0 1
0 1 5 1 1 5 1 1 5 1 1
0 8 0 0 0 0 1 0 0 0 1
0 1 5 1 1 6 1 9 1 9 1
0 1 0 1 0 0 1 0 1 0 1
0 1 0 1 0 0 1 0 1 0 1
30 1 0 1 0 0 1 0 1 0 1
