1
5 9
1 0
30 0 0 0 0 0 0 0 0 0 0
1 1 1 1 1 1 1 1 1 1 0
0 0 0 5 0 1 0 0 0 1 0
0 0 0 1 0 1 0 0 0 1 0
1 5 1 1 0 1 1 1 0 1 0
0 0 0 1 0 5 0 0 0 1 0
0 0 0 1 0 1 1 1 1 1 0
1 5 1 1 0 0 0 0 0 0 0
0 0 0 1 1 7 1 1 1 5 1
0 0 0 1 0 0 0 1 0 0 0
0 0 0 1 0 31 0 1 0 0 0
