14
5 9
5 0
1 0 131 203 30 0 0 0 0 0 1
1 0 205 1 1 1 1 1 205 0 1
1 0 1 1 1 1 1 1 1 0 1
1 0 1 1 1 206 1 1 1 0 1
1 0 1 1 1 9 1 1 1 0 1
1 0 204 1 1 123 1 1 204 0 1
1 0 3 3 1 128 1 3 3 0 1
1 0 3 3 1 123 1 3 3 0 1
1 0 3 3 1 6 1 3 3 0 1
1 120 121 120 6 0 6 120 121 120 1
1 1 1 1 1 31 1 1 1 1 1