15
3 0
7 0
0 0 0 0 31 3 30 0 0 0 0
0 3 3 3 3 3 3 3 3 3 0
0 3 3 1 1 1 1 1 3 3 0
0 3 1 1 406 1 405 1 1 3 0
0 3 1 1 208 1 208 1 1 3 0
0 3 1 1 207 1 207 1 1 3 0
0 3 3 1 0 1 0 1 3 3 0
0 3 3 1 5 1 5 1 3 3 0
0 3 3 3 0 0 0 3 3 3 0
0 3 3 3 3 7 3 3 3 3 0
0 0 0 0 0 0 0 0 0 0 0