0
5 10
5 2

1 1 1 1 1 1 1 1 1 1 1
1 2 0 2 0 30 0 3 0 3 1
1 0 0 0 0 0 0 0 0 0 1
1 0 0 0 0 0 0 0 0 0 1
1 0 550 0 0 0 0 0 560 0 1
1 0 0 0 0 0 0 0 0 0 1
1 0 520 0 0 0 0 0 530 0 1
1 0 0 0 0 0 0 0 0 0 1
1 510 511 512 0 0 0 540 541 542 1
1 0 0 0 0 0 0 0 0 0 1
1 1 1 0 0 0 0 0 1 1 1

1 3 3 3 3 30 3 3 3 3 1
1 3 3 3 3 0 3 3 3 3 1
1 3 3 3 3 0 3 3 3 3 1
1 3 3 3 3 0 3 3 3 3 1
1 3 3 3 3 0 3 3 3 3 1
1 3 3 3 3 0 3 3 3 3 1
1 3 3 3 3 0 3 3 3 3 1
1 1 1 1 1 5 1 1 1 1 1
2 1 2 1 0 0 0 1 2 1 2
2 2 2 2 2 0 2 2 2 2 2
2 2 2 2 2 0 2 2 2 2 2