9
6 3
6 7
228 200 0 1 1 1 0 0 0 1 0
200 0 0 5 0 0 0 1 0 5 0
1 5 1 1 0 1 1 1 0 1 200
0 0 0 1 0 1 0 0 0 1 200
0 0 0 7 0 1 31 1 0 1 204
1 6 1 1 0 1 1 1 0 1 1
208 0 207 1 0 1 30 1 0 1 204
1 5 1 1 0 0 0 5 0 1 200
0 204 0 1 1 6 1 1 0 1 200
201 0 204 1 0 0 0 1 0 5 0
211 201 0 5 205 0 205 1 0 1 0