1
5 9
1 0
30 0 200 0 0 0 0 0 0 0 0
1 1 1 1 1 1 1 1 1 1 0
204 0 0 5 0 1 204 200 204 1 0
200 0 207 1 0 1 204 200 204 1 0
1 5 1 1 0 1 1 1 0 1 0
200 0 0 1 0 5 0 0 0 1 0
208 0 201 1 0 1 1 1 1 1 0
1 5 1 1 0 0 0 0 0 0 0
0 0 0 1 1 7 1 1 1 5 1
204 205 200 1 202 0 0 1 200 0 201
204 225 200 1 0 31 0 1 200 200 200

30 0 0 0 0 0 0 0 0 0 0
1 1 1 1 1 1 1 1 1 1 0
0 0 0 5 0 1 0 0 0 1 0
0 0 0 1 0 1 0 0 0 1 0
1 5 1 1 0 1 1 1 0 1 0
0 0 0 1 0 5 0 0 0 1 0
0 0 0 1 0 1 1 1 1 1 0
1 5 1 1 0 0 0 0 0 0 0
0 0 0 1 1 7 1 1 1 5 1
0 0 0 1 0 0 0 1 0 0 0
0 0 0 1 0 31 0 1 0 0 0


