10
4 6
0 9
0 1 1 208 0 1 0 207 1 1 0
0 0 1 1 5 1 5 1 1 0 0
0 0 0 0 0 1 0 0 0 0 205
0 1 0 1 1 1 1 1 0 1 1
0 1 0 0 200 200 200 0 0 1 200
0 1 0 1 1 1 1 5 1 1 200
0 1 0 9 0 31 1 0 5 0 0
0 1 1 1 1 1 1 5 1 1 0
0 1 204 208 207 1 0 0 0 1 200
0 1 204 208 207 7 0 1 0 1 200
30 1 204 208 207 1 201 1 201 1 204