11
1 10
9 10
204 1 200 1 201 1 202 1 205 217 205
204 1 200 1 201 1 202 1 120 121 120
204 1 200 1 201 1 202 1 0 120 0
5 1 5 1 5 1 5 1 1 6 1
0 0 0 0 0 1 0 0 0 0 0
5 1 1 6 1 1 1 6 1 1 5
208 1 0 120 205 122 205 120 0 1 207
208 1 119 1 1 1 1 1 119 1 207
208 1 119 1 540 541 542 1 119 1 207
1 1 7 1 204 0 204 1 7 1 1
31 0 0 0 0 0 0 0 0 0 30