21
5 5
2
5 1 22 5 1
5 7 20 5 6
3 3 3 3 3 3 3 3 3 3 3
3 3 0 0 3 139 3 0 0 3 3
3 0 0 3 3 126 3 3 0 0 3
3 0 0 0 3 126 3 0 0 0 3
3 3 0 0 0 0 0 0 0 3 3
3 3 0 0 0 0 0 0 0 3 3
3 3 3 0 0 3 0 0 3 3 3
3 3 3 3 9 31 9 3 3 3 3
3 3 3 3 3 3 3 3 3 3 3
3 3 3 3 3 3 3 3 3 3 3
3 3 3 3 3 3 3 3 3 3 3
