25
9 5
1
10 5 22 1 5
133 0 0 207 207 207 0 0 3 0 205
0 3 3 3 3 3 3 0 6 0 3
207 3 3 127 133 133 133 0 3 0 3
207 3 3 220 3 3 3 3 3 0 3
0 127 3 3 3 3 3 3 219 0 3
3 7 140 9 223 3 3 219 6 0 31
0 127 3 3 3 3 3 3 219 0 3
207 3 3 220 3 3 3 3 3 0 3
207 3 3 127 133 133 133 0 3 0 3
0 3 3 3 3 3 3 0 6 0 3
133 0 0 207 207 207 0 0 3 0 205