7
5 10
1 0 
30 0 0 0 0 0 0 0 1 1 1
1 1 0 0 1 6 1 0 0 1 1
1 0 0 208 1 0 1 207 0 0 1
0 0 1 1 1 9 1 1 1 0 0
0 0 6 0 9 222 9 0 6 0 0
0 1 1 1 1 9 1 1 1 1 0
0 1 204 207 1 0 1 208 204 1 0
0 1 200 204 1 6 1 204 200 1 0
0 1 1 201 201 205 201 201 1 1 0
0 0 1 1 1 7 1 1 1 0 0
1 0 0 5 31 0 0 5 0 0 1