0
5 10
5 2
1 1 1 1 1 1 1 1 1 1 1
1 2 0 2 0 30 0 3 0 3 1
1 0 0 0 0 0 0 0 0 0 1
1 0 0 0 0 0 0 0 0 0 1
1 0 0 0 0 0 0 0 0 0 1
1 0 0 5 6 7 8 9 0 0 1
1 0 0 5 6 7 8 9 0 0 1
1 0 0 0 0 0 0 0 0 0 1
1 0 0 0 0 0 0 0 0 0 1
1 0 0 0 0 0 0 0 0 0 1
1 1 1 0 0 0 0 0 1 1 1