1 3 3 3 3 30 3 3 3 3 1
1 3 3 3 3 0 3 3 3 3 1
1 3 3 3 3 0 3 3 3 3 1
1 3 3 3 3 0 3 3 3 3 1
1 3 3 3 3 0 3 3 3 3 1
1 3 3 3 3 0 3 3 3 3 1
1 3 3 3 3 0 3 3 3 3 1
1 1 1 1 1 5 1 1 1 1 1
2 1 2 1 0 0 0 1 2 1 2
2 2 2 2 2 0 2 2 2 2 2
2 2 2 2 2 0 2 2 2 2 2

1 1 1 1 1 1 1 1 1 1 1
1 0 0 0 0 30 0 0 0 0 1
1 0 0 0 0 0 0 0 0 0 1
1 0 0 0 0 0 0 0 0 0 1
1 0 0 0 0 0 0 0 0 0 1
1 0 0 0 0 0 0 0 0 0 1
1 0 0 0 0 0 0 0 0 0 1
1 0 0 0 0 0 0 0 0 0 1
1 0 0 0 0 0 0 0 0 0 1
1 0 0 0 0 0 0 0 0 0 1
1 1 1 0 0 0 0 0 1 1 1

1 1 1 1 1 1 1 1 1 1 1
1 2 0 2 0 30 0 3 0 3 1
1 0 0 0 0 0 0 0 0 0 1
1 100 101 102 103 0 104 105 106 107 1
1 108 109 110 111 0 112 113 114 115 1
1 116 117 118 119 0 120 121 122 123 1
1 124 125 126 127 0 128 129 130 131 1
1 132 133 134 135 0 136 137 138 139 1
1 140 0 0 0 0 0 0 0 0 1
1 0 0 0 0 0 0 0 0 0 1
1 1 1 0 0 0 0 0 1 1 1

1 1 1 1 1 1 1 1 1 1 1
1 2 0 2 0 30 0 3 0 3 1
1 0 0 0 0 0 0 0 0 0 1
1 0 0 5 6 7 8 9 0 0 1
1 0 0 200 201 202 203 204 0 0 1
1 0 0 205 206 207 208 210 0 0 1
1 0 0 211 212 214 216 217 0 0 1
1 0 0 219 220 221 222 223 0 0 1
1 0 0 225 226 227 0 0 0 0  1
1 0 0 0 0 0 0 0 0 0 1
1 1 1 0 0 0 0 0 1 1 1

1 1 1 1 1 1 1 1 1 1 1
1 2 0 2 0 30 0 3 0 3 1
1 0 0 0 0 0 0 0 0 0 1
1 0 0 0 0 0 0 0 0 0 1
1 0 550 0 0 0 0 0 560 0 1
1 0 0 0 0 0 0 0 0 0 1
1 0 520 0 0 0 0 0 530 0 1
1 0 0 0 0 0 0 0 0 0 1
1 510 511 512 0 0 0 540 541 542 1
1 0 0 0 0 0 0 0 0 0 1
1 1 1 0 0 0 0 0 1 1 1